XXXXXXXXXXX
XXXXXXXXXXX
XRRRRRRRRRX
XRRRRRRRRRX
XRRXXXXXRRX
XRRXXXXXRRX
XRRXGGGXRRX
XRRXGGGXRRX
XRRXXXXXRRX
XRRXXXXXRRX
XRRRRRRRRRX
XRRRRRRRRRX
