XXXXXXXXXXX
XXXPXXXPXXX
XXPPPXPPPXX
XPPPPPPPPPX
XPPXPPPXPPX
XPPXXPXXPPX
XPPXXXXXPPX
XXPPXXXPPXX
XXPPXXXPPXX
XXXPPXPPXXX
XXXXPPPXXXX
XXXXXPXXXXX
