XXXXXXXXXXX
XXXXXXXXXXX
GGGGGGGGGGG
GGGGXXXGGGG
XGGGXXXGGGX
XXGGXXXGGXX
XXXGXXXGXXX
XXXGXPXGXXX
XXGGPPPGGXX
XGGPPPPPGGX
GGPPPPPPPGG
GGGGGGGGGGG